R 800 500
NO ./tests/path_to_the_north_texture
SO ./tests/path_to_the_south_texture
WE ./tests/path_to_the_west_texture
EA ./tests/path_to_the_east_texture

S ./tests/path_to_the_sprite_texture
F 220,100,0
C 225,30,0

1111111
1000011
1000001
1000001
100N001
1000001
1111111