R 800 600
NO ./tests/path_to_the_north_texture
SO ./tests/path_to_the_south_texture
WE ./tests/path_to_the_west_texture
EA ./tests/path_to_the_east_texture

F 220,100,0
C 225,30,0

1111111
1000001
1001001
1000001
1000001
1N00001
1111111
