NO ./tests/path_to_the_north_texture
SO ./tests/path_to_the_south_texture
WE ./tests/path_to_the_west_texture
EA ./tests/path_to_the_east_texture

F 52,66,37
C 66,135,245

1111111
1000001
1001001
1000001
1000001
1N00001
1111111
